15x15
WWWWWWWWWWWWWWW
W...W..........
W..............
W..............
W..............
W..............
W..............
W..............
W..............
W..............
W..............
W..............
W..............
W..............
W..............
