title
10x15
xxxxxxxxxxxxxxx
x             x
x          w  x
x  #          x
x             x
x         w   x
x   x x  w w  x
x   x         x
x             x
xxxxxxxxxxxxxxx
