WWWWWWWWWWWWWWW
WW............W
W.W...........W
W..W..........W
W...W.........W
W....W........W
W.....W.......W
W......W......W
W.......W.....W
W........W....W
W.........W...W
W..........W..W
W...........W.W
W............WW
WWWWWWWWWWWWWWW
