15x15
xxxxxxxxxxxxxxx
x             x
x          x  x
x             x
x      xxxx   x
x xx          x
x             x
x       xx    x
x     x       x
x             x
xx x       x  x
x             x
x             x
x             x
xxxxxxxxxxxxxxx
