15x15
xxxxxxxxxxxxxxx
x             x
x          x  x
x #           x
x #    wwww   x
x xx          x
x             x
x       xx    x
x     x       x
x             x
xx x       x  x
x             x
x     w  w xx x
x             x
xxxxxxxxxxxxxxx
