10x15
xxxxxxxxxxxxxxx
x             x
x w w ww w  w x
x  ww ww   ww x
x w ww  w w   x
x   w ww   w  x
x w w w     w x
x    w www  w x
x         w   x
xxxxxxxxxxxxxxx
 