WWWWWWWWWWWWWWW
WW.............
W.W............
W..W...........
W..............
W..............
W..............
W..............
W..............
W..............
W..............
W..............
W..............
W..............
W..............
